|||||||||||||||||||||||||||||||||||||||||||||||||||||||
|||||||||||||||||||||||||||||||||||||||||||||||||||||||
||E|           |         |                       |   ||
|| | ||||||||| | ||||| | ||||| ||||||||||||||||| | | ||
|| |   | |     | |     |       |   |         | | | | ||
|| ||| | | ||||||| ||||||||||||| ||| ||||| | | | | | ||
||     | |       | |     |   |       |     |   | | | ||
|||||||| ||||||| | | ||| | | ||| ||||| ||||||| | ||| ||
||       |       |     |   |   |   |   |   |   |   | ||
|| ||||||| ||||||||||||||||||| ||||| ||| ||| ||||| | ||
||         |   |       |       |     |   |   |     | ||
|| ||||||||| | | | ||| | ||||||| ||||| ||| ||| ||||| ||
||       |   | | | |   | |   |   |     |     | |   | ||
|||||||| ||| | | | | ||| | ||| | ||||| | ||||| | | | ||
|| |   |     | | | |     | |   | |   |   | |   | |   ||
|| | | ||||||| ||| ||||||| | ||| | | | ||| | ||| ||| ||
||   |       |   | |         | |   | |     | |   | | ||
|| ||||||| ||||| | | ||||||||| ||||| ||||| | | ||| | ||
|| |     | |   | | |         |   |   |   | | |   | | ||
|| | ||| | | | | | ||||||||| ||| | ||| | ||| ||| | | ||
||   |   |   |     |             |     |         |  S||
|||||||||||||||||||||||||||||||||||||||||||||||||||||||
|||||||||||||||||||||||||||||||||||||||||||||||||||||||