****************
*         *   E*
*    *    *  ***
*    *    *    *
*  * *    *    *
*S * *    *    *
*  * *         *
****************