****************
*         *   E*
*    *    * ** *
*    *    *    *
*    *    *    *
*    *  ***    *
*S             *
****************