****************
*         *   E*
*    ******  ***
*         *    *
*    * ******* *
*    *    * ** *
*S   *         *
****************