****************
*    *    *   E*
*    *    *  ***
*    *    *    *
*    *    *    *
*    *    *    *
*S   *         *
****************