****************
*         *   E*
*    *    *  ***
*    *    *    *
*    *    *    *
*    *    **** *
*S   *         *
****************