****************
*         *   E*
*    ******  ***
*         *    *
*    *    *    *
*    *    *    *
*S   *         *
****************